11111111111111111111111111111111111
1E000000000000000000C00001C0000C001
1110110000C0000011111000C1111000001
1P0000000000000C000C00000100C000001
11100C000100000000000000010000000C1
10000000011000000000000000001111111
100100000C000011100C000000001100001
10C1C000111000001111101000000001101
101110001C00000011C1101000000001101
10010000111000001101101000000001101
100C00000C111000000C1C1000C000001E1
11111111111111111111111111111111111
